6 8
..X.....
.......X
...XX...
........
X....X..
..X..X..
